"filename", "language", "Java", "comment", "blank", "total"
"c:\Users\cgsan\git\csc216-P2-001-072\Project2\src\edu\ncsu\csc216\stp\model\io\TestPlanReader.java", "Java", -84, -29, -7, -120
"c:\Users\cgsan\git\csc216-P2-001-072\Project2\src\edu\ncsu\csc216\stp\model\io\TestPlanWriter.java", "Java", -29, -14, -5, -48
"c:\Users\cgsan\git\csc216-P2-001-072\Project2\src\edu\ncsu\csc216\stp\model\manager\TestPlanManager.java", "Java", -135, -84, -21, -240
"c:\Users\cgsan\git\csc216-P2-001-072\Project2\src\edu\ncsu\csc216\stp\model\test_plans\AbstractTestPlan.java", "Java", -67, -79, -20, -166
"c:\Users\cgsan\git\csc216-P2-001-072\Project2\src\edu\ncsu\csc216\stp\model\test_plans\FailingTestList.java", "Java", -45, -35, -8, -88
"c:\Users\cgsan\git\csc216-P2-001-072\Project2\src\edu\ncsu\csc216\stp\model\test_plans\TestPlan.java", "Java", -40, -29, -7, -76
"c:\Users\cgsan\git\csc216-P2-001-072\Project2\src\edu\ncsu\csc216\stp\model\tests\TestCase.java", "Java", -100, -100, -19, -219
"c:\Users\cgsan\git\csc216-P2-001-072\Project2\src\edu\ncsu\csc216\stp\model\tests\TestResult.java", "Java", -34, -47, -9, -90
"c:\Users\cgsan\git\csc216-P2-001-072\Project2\src\edu\ncsu\csc216\stp\model\util\ILog.java", "Java", -6, -24, -5, -35
"c:\Users\cgsan\git\csc216-P2-001-072\Project2\src\edu\ncsu\csc216\stp\model\util\ISortedList.java", "Java", -8, -38, -7, -53
"c:\Users\cgsan\git\csc216-P2-001-072\Project2\src\edu\ncsu\csc216\stp\model\util\ISwapList.java", "Java", -11, -61, -10, -82
"c:\Users\cgsan\git\csc216-P2-001-072\Project2\src\edu\ncsu\csc216\stp\model\util\Log.java", "Java", -40, -33, -6, -79
"c:\Users\cgsan\git\csc216-P2-001-072\Project2\src\edu\ncsu\csc216\stp\model\util\SortedList.java", "Java", -111, -66, -16, -193
"c:\Users\cgsan\git\csc216-P2-001-072\Project2\src\edu\ncsu\csc216\stp\model\util\SwapList.java", "Java", -108, -80, -14, -202
"c:\Users\cgsan\git\csc216-P2-001-072\Project2\src\edu\ncsu\csc216\stp\view\ui\SystemTestPlanGUI.java", "Java", -702, -167, -153, -1022
"c:\Users\cgsan\git\csc216-P2-001-072\Project2\test\edu\ncsu\csc216\stp\model\io\TestPlanReaderTest.java", "Java", 19, 11, 7, 37
"c:\Users\cgsan\git\csc216-P2-001-072\Project2\test\edu\ncsu\csc216\stp\model\io\TestPlanWriterTest.java", "Java", 53, 16, 7, 76
"c:\Users\cgsan\git\csc216-P2-001-072\Project2\test\edu\ncsu\csc216\stp\model\manager\TestPlanManagerTest.java", "Java", 137, 46, 18, 201
"c:\Users\cgsan\git\csc216-P2-001-072\Project2\test\edu\ncsu\csc216\stp\model\test_plans\AbstractTestPlanTest.java", "Java", 91, 32, 13, 136
"c:\Users\cgsan\git\csc216-P2-001-072\Project2\test\edu\ncsu\csc216\stp\model\test_plans\FailingTestListTest.java", "Java", 64, 23, 11, 98
"c:\Users\cgsan\git\csc216-P2-001-072\Project2\test\edu\ncsu\csc216\stp\model\test_plans\TestPlanTest.java", "Java", 51, 20, 8, 79
"c:\Users\cgsan\git\csc216-P2-001-072\Project2\test\edu\ncsu\csc216\stp\model\tests\TestCaseTest.java", "Java", 79, 32, 14, 125
"c:\Users\cgsan\git\csc216-P2-001-072\Project2\test\edu\ncsu\csc216\stp\model\tests\TestResultTest.java", "Java", 34, 20, 7, 61
"c:\Users\cgsan\git\csc216-P2-001-072\Project2\test\edu\ncsu\csc216\stp\model\util\LogTest.java", "Java", 40, 20, 8, 68
"c:\Users\cgsan\git\csc216-P2-001-072\Project2\test\edu\ncsu\csc216\stp\model\util\SortedListTest.java", "Java", 80, 26, 12, 118
"c:\Users\cgsan\git\csc216-P2-001-072\Project2\test\edu\ncsu\csc216\stp\model\util\SwapListTest.java", "Java", 138, 35, 12, 185
"Total", "-", -734, -605, -190, -1529