"filename", "language", "Java", "comment", "blank", "total"
"c:\Users\cgsan\git\csc216-P2-001-072\Project2\test\edu\ncsu\csc216\stp\model\io\TestPlanReaderTest.java", "Java", 19, 11, 7, 37
"c:\Users\cgsan\git\csc216-P2-001-072\Project2\test\edu\ncsu\csc216\stp\model\io\TestPlanWriterTest.java", "Java", 53, 16, 7, 76
"c:\Users\cgsan\git\csc216-P2-001-072\Project2\test\edu\ncsu\csc216\stp\model\manager\TestPlanManagerTest.java", "Java", 137, 46, 18, 201
"c:\Users\cgsan\git\csc216-P2-001-072\Project2\test\edu\ncsu\csc216\stp\model\test_plans\AbstractTestPlanTest.java", "Java", 91, 32, 13, 136
"c:\Users\cgsan\git\csc216-P2-001-072\Project2\test\edu\ncsu\csc216\stp\model\test_plans\FailingTestListTest.java", "Java", 64, 23, 11, 98
"c:\Users\cgsan\git\csc216-P2-001-072\Project2\test\edu\ncsu\csc216\stp\model\test_plans\TestPlanTest.java", "Java", 51, 20, 8, 79
"c:\Users\cgsan\git\csc216-P2-001-072\Project2\test\edu\ncsu\csc216\stp\model\tests\TestCaseTest.java", "Java", 79, 32, 14, 125
"c:\Users\cgsan\git\csc216-P2-001-072\Project2\test\edu\ncsu\csc216\stp\model\tests\TestResultTest.java", "Java", 34, 20, 7, 61
"c:\Users\cgsan\git\csc216-P2-001-072\Project2\test\edu\ncsu\csc216\stp\model\util\LogTest.java", "Java", 40, 20, 8, 68
"c:\Users\cgsan\git\csc216-P2-001-072\Project2\test\edu\ncsu\csc216\stp\model\util\SortedListTest.java", "Java", 80, 26, 12, 118
"c:\Users\cgsan\git\csc216-P2-001-072\Project2\test\edu\ncsu\csc216\stp\model\util\SwapListTest.java", "Java", 138, 35, 12, 185
"Total", "-", 786, 281, 117, 1184