"filename", "language", "Java", "comment", "blank", "total"
"c:\Users\cgsan\git\csc216-P2-001-072\Project2\src\edu\ncsu\csc216\stp\model\io\TestPlanReader.java", "Java", 84, 29, 7, 120
"c:\Users\cgsan\git\csc216-P2-001-072\Project2\src\edu\ncsu\csc216\stp\model\io\TestPlanWriter.java", "Java", 29, 14, 5, 48
"c:\Users\cgsan\git\csc216-P2-001-072\Project2\src\edu\ncsu\csc216\stp\model\manager\TestPlanManager.java", "Java", 135, 84, 21, 240
"c:\Users\cgsan\git\csc216-P2-001-072\Project2\src\edu\ncsu\csc216\stp\model\test_plans\AbstractTestPlan.java", "Java", 67, 79, 20, 166
"c:\Users\cgsan\git\csc216-P2-001-072\Project2\src\edu\ncsu\csc216\stp\model\test_plans\FailingTestList.java", "Java", 45, 35, 8, 88
"c:\Users\cgsan\git\csc216-P2-001-072\Project2\src\edu\ncsu\csc216\stp\model\test_plans\TestPlan.java", "Java", 40, 29, 7, 76
"c:\Users\cgsan\git\csc216-P2-001-072\Project2\src\edu\ncsu\csc216\stp\model\tests\TestCase.java", "Java", 100, 100, 19, 219
"c:\Users\cgsan\git\csc216-P2-001-072\Project2\src\edu\ncsu\csc216\stp\model\tests\TestResult.java", "Java", 34, 47, 9, 90
"c:\Users\cgsan\git\csc216-P2-001-072\Project2\src\edu\ncsu\csc216\stp\model\util\ILog.java", "Java", 6, 24, 5, 35
"c:\Users\cgsan\git\csc216-P2-001-072\Project2\src\edu\ncsu\csc216\stp\model\util\ISortedList.java", "Java", 8, 38, 7, 53
"c:\Users\cgsan\git\csc216-P2-001-072\Project2\src\edu\ncsu\csc216\stp\model\util\ISwapList.java", "Java", 11, 61, 10, 82
"c:\Users\cgsan\git\csc216-P2-001-072\Project2\src\edu\ncsu\csc216\stp\model\util\Log.java", "Java", 40, 33, 6, 79
"c:\Users\cgsan\git\csc216-P2-001-072\Project2\src\edu\ncsu\csc216\stp\model\util\SortedList.java", "Java", 111, 66, 16, 193
"c:\Users\cgsan\git\csc216-P2-001-072\Project2\src\edu\ncsu\csc216\stp\model\util\SwapList.java", "Java", 108, 80, 14, 202
"c:\Users\cgsan\git\csc216-P2-001-072\Project2\src\edu\ncsu\csc216\stp\view\ui\SystemTestPlanGUI.java", "Java", 702, 167, 153, 1022
"Total", "-", 1520, 886, 307, 2713